cent	cent (R)
enumerate	enumer (R) ate (S)
vend	vend (R)
lair	lair (R)
leukaemia	leuk (P) aemia (R)
industrious	industry (R) ious (S)
encyclopedia	encyclo (P) pe (R) dia (R)
emphasise	emphase (R) ise (S)
defense	defend (R) se (S)
diarrhea	dia (R) rrhea (S)
colonisation	colon (R) ise (S) ation (S)
colonise	colon (R) ise (S)
whisky	whisk (R) y (S)
whiskey	whisk (R) ey (S)
carburettor	carb (P) ure (R) ttor (S)
thermometry	thermo (P) metry (R)
symmetry	symmetr (R) y (S)
wintery	winter (R) y (S)
wintry	winter (R) y (S)
willful	will (R) ful (S)
wilful	will (R) ful (S)
vigour	vigour (R)
vigor	vigor (R)
cheque	cheque (R)
check	check (R)
cesarean	cesar (R) ean (S)
caesium	caes (R) ium (S)
cesium	caes (R) ium (S)
armour	armour (R)
armor	armor (R)
annexe	annexe (R)
annex	annex (R)
anaemia	anaem (R) ia (S)
anemia	anem (R) ia (S)
acknowledgment	ac (P) know (R) ledge (S) ment (S)
aluminum	alumin (P) um (R)
prise	prise (R)
prize	prize (R)
Prismane	prism (R) ane (S)
tranquil	tranquil (R)
triquinacene	tri (P) quin (P) ace (R) ne (S)
dodecahedral	do (R) deca (P) hedr (R) al (S)
Dodecahedrane	do (R) deca (P) hedr (R) ane (S)
menses	menses (R)
allelomorphs	allel (P) om (P) orph (R) s (S)
analyst	analy (R) yst (S)
synaeresis	syne (R) re (P) sis (R)
synergize	synerg (R) ize (S)
synergy	synerg (R) y (S)
dotaplus	dot (R) a (P) plus (R)
Bristleback	bristle (R) back (S)
Octarine	octa (P) rine (R)
resume	resume (R)
retaliate	retaliate (R)
monetisation	monet (R) ise (S) ation (S)
reliant	rely (R) iant (S)
theorycraft	theory (R) craft (S)
numbercrunching	number (R) crunch (R) ing (S)
prevalent	prevale (R) ent (S)
buff	buff (R)
buffolo	buff (R) ole (S) o (S)
sensuous	sense (R) uous (S)
gaze	gaze (R)
monetise	monet (R) ise (S)
affiliations	affili (R) ation (S) s (S)
nav	nav (R)
navigate	navig (R) ate (S)
janitor	janit (R) or (S)
findings	find (R) ing (S) s (S)
bindings	bind (R) ing (S) s (S)
bird	bird (R)
feline	feline (R)
challenge	challenge (R)
insomnia	in (P) somni (P) a (R)
insomiac	in (P) some (R) iac (S)
leet	leet (R)
dependabot	depend (R) ab (P) ot (R)
hellotoby	hello (R) toby (R)
citysuper	city (R) super (R)
simpson	simp (R) son (S)
gesture	geste (R) ure (S)
nemo	nem (R) o (S)
copenhagen	cope (R) en (S) hagen (R)
gauge	gauge (R)
asana	a (P) sane (R) a (S)
proprietary	propriet (R) ary (S)
scandalized	scandal (R) ize (S) ed (S)
benioff	ben (P) i (P) off (R)
mysteries	mystery (R) ies (S)
mysterious	mystery (R) ious (S)
cleanse	cleanse (R)
nanonets	nano (P) net (R) s (S)
throne	throne (R)
aiding	aid (R) ing (S)
companies	company (R) ies (S)
turnover	turn (R) over (S)
healthcare	heal (R) th (S) care (S)
subtract	subtract (R)
abstract	abstract (R)
framework	frame (R) work (R)
winograd	wine (R) o (S) grad (R)
achieve	achieve (R)
upcoming	up (R) come (R) ing (S)
essential	esse (R) ent (S) ial (S)
stewardship	steward (R) ship (S)
algo	algo (R)
algorithm	algo (R) rithm (S)
logo	logo (R)
inbuilt	in (P) build (R) ed (S)
understand	understand (R)
outstanding	out (P) stand (R) ing (S)
coursera	course (R) ra (S)
opportunity	opportune (R) ity (S)
revolutionizing	revolute (R) ion (S) ize (S) ing (S)
parallelbots	parallel (R) bot (R) s (S)
masterclass	master (R) class (R)
nugget	nugget (R)
modalities	mod (R) alit (R) ies (S)
scratch	scratch (R)
loan	loan (R)
orchestration	orch (P) e (R) stration (S)
aquamarine	aqua (P) marine (R)
eugene	eugene (R)
onslaught	on (P) slaught (R)
penned	pen (R) ed (S)
emerson	em (P) er (R) son (S)
insult	insult (R)
squabble	squabble (R)
overwhelmingly	over (R) whelm (R) ing (S) ly (S)
sumbol	s (R) umb (S) ol (S)
expulsion	expulse (R) ion (S)
advocates	advoc (R) ate (S) es (S)
advertisements	advertise (R) ment (S) s (S)
extradition	extradite (R) ion (S)
jurisdiction	jurisd (R) ic (S) tion (S)
enclave	en (P) clave (R)
scuffles	scuff (R) le (S) es (S)
ngo	ngo (R)
assert	assert (R)
insert	insert (R)
desert	desert (R)
dessert	dessert (R)
compelled	compel (R) ed (S)
taiwan	tai (R) wan (R)
taiwanese	tai (R) wan (R) ese (S)
encouragement	en (P) courage (R) ment (S)
wechat	we (R) chat (R)
psycho	psyche (R) o (S)
jar	jar (R)
jarring	jar (R) ing (S)
panicking	panick (R) ing (S)
renaissance	re (P) born (R) ance (S)
tame	tame (R)
taming	tame (R) ing (S)
dawdler	dawdle (R) er (S)
portmanteau	port (R) mant (R) eau (S)
kidault	kid (R) adult (R)
immensely	immense (R) ly (S)
ankle	ankle (R)
sprain	sprain (R)
spain	spain (R)
spanish	spain (R) ish (S)
throttle	throttle (R)
verdatile	ver (R) date (R) ile (S)
versatile	versatile (R)
demystifying	de (P) myst (R) ify (S) ing (S)
cancellation	cancel (R) ation (S)
superb	super (P) b (R)
escalates	escale (R) ate (S) s (S)
pitfall	pit (R) fall (R)
wolfenstein	wolf (R) en (P) stein (R)
bundle	bundle (R)
radically	radical (R) ly (S)
enlightenment	en (P) light (R) ene (S) ment (S)
bodhisattvas	bodhis (R) at (P) vas (R)
Dhammapala	d (R) ham (R) ap (P) ala (R)
truthfulness	true (R) th (S) ful (S) ness (S)
cultivate	cultiv (R) ate (S)
perfection	perfect (R) ion (S)
feminism	femin (R) ism (S)
leapfrog	leap (R) frog (R)
saggy	sag (R) y (S)
prokaryotic	pro (P) karyote (R) ic (S)
disrupt	dis (P) rupt (R)
libretist	libre (R) tist (S)
coarsen	coarse (R) en (S)
enchantress	en (P) chant (R) ress (S)
Ficus carica	ficus (R) care (R) ic (S) a (S)
irish	irish (R)
mattress	matt (R) ress (S)
dominoes	domin (R) o (S) es (S)
guinness	guin (R) ness (S)
aquaman	aqua (P) man (R)
atlanna	at (P) lan (R) na (S)
Mydashboard	my (R) dash (R) board (R)
dystopia	dys (P) topia (R)
flaunt	flaunt (R)
regen	reg (R) en (S)
strengthening	streng (R) then (R) ing (S)
dissonance	dis (P) sone (R) ance (S)
cognitive	cogn (R) itive (S)
believe	believe (R)
belief	belief (R)
synchronous	synchron (R) ous (S)
asynchronous	a (P) synchron (R) ous (S)
endorse	en (P) dorse (R)
remedy	remedy (R)
creed	creed (R)
nudge	nudge (R)
secular	secular (R)
broach	broach (R)
emphasized	emphas (R) ize (S) ed (S)
hierarchies	hierarch (R) ies (S)
false	false (R)
Mitelman	mite (R) el (S) man (S)
millennials	millen (R) ial (S) s (S)
tribal	tribe (R) al (S)
recriminations	re (P) crime (R) ine (S) ation (S) s (S)
polemicizing	polem (R) ic (S) ize (S) ing (S)
vendor	vend (R) or (S)
efficientnet	effic (R) ient (S) net (S)
anaerobic	an (P) aero (P) bi (P) c (R)
stawtled	stawtle (R) ed (S)
quaver	quaver (R)
demisemiquaver	demi (P) semi (P) quaver (R)
argentina	argent (R) ina (S)
aspartina	aspart (R) ina (S)
pyrokinesis	pyro (P) kine (P) sis (R)
spokesmanships	speak (S) ed (S) sman (S) ship (S) s (S)
tranquilizer	tranquil (R) ize (S) er (S)
halcyon	halcyon (R)
serene	serene (R)
still	still (R)
calm	calm (R)
xenophobia	xeno (P) phobe (R) ia (S)
resurgent	re (P) surge (R) ent (S)
maneuver	maneuver (R)
qualcomm	qual (R) comm (R)
kitten	kitten (R)
remainingmaterial	remain (R) ing (S) materi (R) al (S)
propaganda	propaganda (R)
propagandise	propagand (R) ise (S)
propagandism	propagand (R) ism (S)
cascading	cascade (R) ing (S)
mortem	mort (R) em (R)
divorce	divorce (R)
sitcom	sit (R) com (R)
linguist	lingu (R) ist (S)
percipitation	percipi (P) tat (R) ion (S)
contumacious	cont (R) um (S) ace (S) ious (S)
contuse	cont (R) use (R)
bespoke	b (R) e (P) speak (S) ed (S)
cohort	cohort (R)
spew	spew (R)
multimodal	multi (P) mode (R) al (S)
biannually	bian (R) ual (S) ly (S)
plunge	plunge (R)
suffice	suffice (R)
desoldering	de (P) solder (R) ing (S)
interchangable	inter (P) change (R) able (S)
reimplant	re (P) im (P) plant (R)
horizontal	horizon (R) tal (S)
arches	arche (R) es (S)
arched	arche (R) ed (S)
archetype	arche (P) type (R)
bipartite	bi (P) part (R) ite (S)
substituent	substitu (R) ent (S)
substitute	substitu (R) te (S)
fireenabled	fire (R) na (S) bleed (R) ed (S)
ethereum	ether (R) eum (S)
dealership	deal (R) er (S) ship (S)
adoption	adopt (R) ion (S)
compare	compare (R)
comparison	compare (R) is (S) on (S)
spat	spit (R) ed (S)
crawford	craw (R) ford (R)
perserverance	per (P) serve (R) rance (S)
demoralize	de (P) moral (R) ize (S)
demoralizing	de (P) moral (R) ize (S) ing (S)
mansion	man (R) sion (S)
straw	straw (R)
brick	brick (R)
bahrain	bah (R) rain (R)
tenant	ten (R) ant (S)
foregrip	fore (P) grip (R)
unceremoniously	un (P) ceremon (R) ious (S) ly (S)
miscommunication	mis (P) communic (R) ation (S)
scrupper	scrup (R) er (S)
ransomware	ransom (R) ware (S)
vow	vow (R)
morpheus	morph (P) eu (P) s (R)
laxative	lax (R) ative (S)
deleteriois	delete (R) rio (R) is (S)
memorandum	memor (R) and (S) um (S)
bleedover	bleed (R) over (S)
espionage	espi (R) one (S) age (S)
stoked	stoke (R) ed (S)
autism	aut (P) ism (R)
Criticism	critic (R) ism (S)
forecasting	fore (P) cast (R) ing (S)
regulators	regul (R) ate (S) or (S) s (S)
Thankfully	thank (R) ful (S) ly (S)
whopping	who (R) p (R) ing (S)
Adverseness	adverse (R) ness (S)
steadfastly	stead (R) fast (R) ly (S)
strata	strat (R) um (S) s (P)
artesian	artes (R) ian (S)
climactic	clim (R) act (S) ic (S)
feast	feast (R)
beast	beast (R)
tease	tease (R)
brim	brim (R)
trim	trim (R)
prim	prim (R)
grin	grin (R)
crime	crime (R)
crim	crim (R)
depth	deep (R) th (P)
infusing	in (P) fuse (R) ing (S)
november	novem (R) ber (S)
johnston	john (R) st (S) on (S)
kingston	king (R) st (S) on (S)
boston	boston (R)
czech	czech (R)
glare	glare (R)
sabotage	sabot (R) age (S)
boar	boar (R)
intricacy	intric (R) acy (S)
clutter	clutter (R)
goggle	goggle (R)
powder	powder (R)
power	power (R)
nod	nod (R)
nood	n (R) oo (P) d (R)
curfew	cur (P) few (R)
chant	chant (R)
safeguard	safe (R) guard (R)
asphalt	asphalt (R)
gravel	grave (R) el (S)
katagana	kata (P) gan (R) a (S)
sue	sue (R)
ensue	follow (R) ed (S)
kaizen	kai (R) zen (S)
environmentalism	environ (R) mental (R) ism (S)
wean	wean (R)
suspicion	suspic (R) ion (S)
repressive	re (P) press (R) ive (S)
regal	regal (R)
overheard	over (R) hear (R) d (S)
effortlessly	effort (R) less (S) ly (S)
controversial	controverse (R) ial (S)
kwong	kwong (R)
martyr	mar (R) ty (S) r (R)
preacher	preach (R) er (S)
baptizer	bapt (R) ize (S) er (S)
thronged	throng (R) ed (S)
Judea	jude (R) a (S)
Jerusalem	jer (R) usa (R) lem (R)
camel	camel (R)
waist	waist (R)
locusts	locust (R) s (S)
stagehand	stage (R) hand (R)
galilee	gal (R) ile (S) e (S)
nazareth	na (R) zar (S) eth (R)
wilderness	wild (R) ern (S) ess (S)
incredulous	in (P) cred (R) ulous (S)
buzzing	buzz (R) ing (S)
afflict	afflict (R)
tormented	torment (R) ed (S)
tor	tor (R)
demon	demon (R)
leprosy	lepro (R) sy (S)
leprotic	lepro (R) te (S) ic (S)
leprose	lepro (R) se (S)
leprous	lepro (R) us (S)
prescribe	prescribe (R)
perch	perch (R)
forth	forth (R)
forthright	forth (R) right (R)
capernaum	caper (R) na (S) um (S)
sabbath	sabbath (R)
zebedee	zeb (R) ed (S) ee (S)
mend	mend (R)
fishnet	fish (R) net (S)
dozen	dozen (R)
yard	yard (R)
fisherman	fish (R) er (S) man (S)
fishermen	fish (R) er (S) men (S)
isaiah	isa (R) iah (S)
prophet	prophet (R)
comrade	comrade (R)
celebrity	celebr (R) ity (S)
advocacy	advoc (R) acy (S)
theoretical	theor (R) et (S) ic (S) al (S)
overconfidence	over (R) confide (R) ence (S)
themselves	them (R) self (S) s (P)
recounting	re (P) count (R) ing (S)
egregious	egreg (R) ious (S)
aka	aka (R)
postdoc	post (P) doc (R)
reynold	reynold (R)
enlightening	en (P) light (R) en (S) ing (S)
ethereum	ether (R) eum (S)
dealership	deal (R) er (S) ship (S)
dynasty	dynast (R) y (S)
examine	examine (R)
ideology	ideo (R) olog (S) y (S)
catapult	cata (P) pu (R) lt (S)
ciprioni	ci (P) pre (R) ion (S) i (S)
benefactor	bene (P) factor (R)
epionage	epi (P) one (R) age (S)
gunslinger	gun (R) sling (R) er (S)
abate	abate (R)
miniaturize	mini (P) a (P) tur (R) ize (S)
stalk	stalk (R)
professional	profess (R) ion (S) al (S)
seizure	seize (R) ure (S)
relevatory	relev (R) ate (S) ory (S)
hurl	hurl (R)
entail	en (P) tail (R)
duplicitous	duplic (R) ite (S) ous (S)
stalker	stalk (R) er (S)
remodel	re (P) model (R)
reassigned	re (P) assign (R) ed (S)
renegotiate	re (P) negoti (R) ate (S)
reinstated	rein (R) state (R) ed (S)
grabbed	grab (R) ed (S)
revolutionary	revolute (R) ion (S) ary (S)
whistles	whistle (R) es (S)
tendancy	tend (R) ancy (S)
vengeance	ve (R) ng (R) eance (S)
grizzly	grizz (R) ly (S)
generalization	general (R) ize (S) ation (S)
general	general (R)
rumor	rumor (R)
hub	hub (R)
decoration	decorate (R) ion (S)
wrought	work (R) ed (S)
pneumothorax	pneumo (P) thorax (R)
radiographic	radio (P) graph (R) ic (S)
chomsky	cho (R) m (S) sky (R)
union	uni (P) on (R)
asymptote	a (P) sym (P) p (R) tote (S)
abysmally	abysm (R) al (S) ly (S)
labmate	lab (R) mate (R)
laboratory	laboratory (R)
bullet	bullet (R)
chamber	chamber (R)
dinosaurs	dinosaur (R) s (S)
princesses	prince (R) es (S) se (S) es (S)
consulates	consul (R) ate (S) es (S)
proprioceptive	proprio (P) cep (R) tive (S)
hypocrisy	hypo (P) cr (P) is (R) y (S)
refrain	refrain (R)
duane	duane (R)
zendesk	zen (R) desk (R)
hijack	hi (R) jack (R)
merkin	mer (R) kin (S)
predestination	pre (P) de (P) st (P) i (P) nation (R)
pretokenization	pre (P) token (R) ize (S) ation (S)
precheck	pre (P) check (R)
vivification	vivi (P) f (R) ice (S) ation (S)
econometric	econom (R) et (S) ry (S) ic (S)
tendril	tendr (R) il (S)
cybersecurity	cyber (P) secure (R) ity (S)
embattled	em (P) battle (R) ed (S)
hawks	hawk (R) s (S)
demonic	demon (R) ic (S)
healthcare	heal (R) th (S) care (S)
superexistent	super (P) exist (R) ent (S)
zoomedpicture	zoom (R) ed (S) picture (R)
proofofconcept	proof (R) of (P) concept (R)
resurface	re (P) surface (R)
heartfelt	heart (R) feel (R) ed (S)
mishandling	mis (P) handle (R) ing (S)
graffiti	graffiti (R)
obscene	ob (P) scene (R)
vandalism	vandal (R) ism (S)
harassment	ha (P) ras (R) ment (S)
dissatisfy	dis (P) satisfy (R)
disapproving	dis (P) approve (R) ing (S)
commissioner	commiss (R) ion (S) er (S)
procession	process (R) ion (S)
watchdog	watch (R) dog (R)
crowd	crowd (R)
saught	s (P) aught (R)
escalated	escale (R) ate (S) d (S)
withdrawal	withdraw (R) al (S)
postwithdrawal	post (P) withdraw (R) al (S)
defy	defy (R)
awe	awe (R)
awful	aw (R) ful (S)
stimulus	stimul (R) us (S)
inductive	induct (R) ive (S)
biases	bias (R) es (S)
reckon	reckon (R)
behemoth	behemoth (R)
stakes	stake (R) es (S)
wagyu	wag (R) yu (R)
sando	sand (R) o (S)
dissemination	dissemin (R) ation (S)
burgeoned	burg (R) eo (S) ne (S) ed (S)
avenue	avenue (R)
paywall	pay (R) wall (R)
idiosynractic	idio (P) syn (P) r (R) act (S) ic (S)
squandering	squ (P) ander (R) ing (S)
dictate	dict (R) ate (S)
flinch	flinch (R)
invocations	invocate (R) ion (S) s (S)
learnmachinelearning	learn (R) mach (R) ine (S) learn (R) ing (S)
sapien	sapi (R) en (S)
evildoers	evil (R) do (R) er (S) s (S)
tonsillitus	tonsill (R) ite (S) us (S)
tonsil	tonsil (R)
raspberry	rasp (R) berry (R)
happiness	happy (R) iness (S)
semester	semester (R)
overpromise	over (R) promise (R)
peculiarity	peculi (R) ar (S) ity (S)
stratify	strat (R) ify (S)
humble	humble (R)
polygyny	poly (P) gyne (R) y (S)
polyandry	poly (P) andre (R) y (S)
polyandrous	poly (P) andre (R) ous (S)
paganism	pagan (R) ism (S)
Heathenism	heathen (R) ism (S)
contemporary	contempor (R) ary (S)
Neopaganism	neo (P) pagan (R) ism (S)
Heathenry	heathen (R) ry (S)
broker	broker (R)
cleat	cleat (R)
dissent	dis (P) sent (R)
sneakily	sneak (R) ily (S)
striait	stri (R) ait (S)
strait	strait (R)
scrutiny	scrutin (R) y (S)
wobbles	wobble (R) es (S)
systolic	systole (R) ic (S)
template	template (R)
cartel	cart (R) el (S)
encyclopedic	encyclo (P) ped (P) i (P) c (R)
repercussion	re (P) percuss (R) ion (S)
discusting	dis (P) cust (R) ing (S)
verboten	verb (R) ote (S) en (S)
prosthesis	prosthe (R) sis (S)
falter	falt (R) er (S)
ecclesiastes	eccles (R) iast (S) es (S)
lacy	lace (R) y (S)
dormant	dorm (R) ant (S)
dominate	domin (R) ate (S)
bug	bug (R)
debug	de (P) bug (R)
print	print (R)
foster	foster (R)
dexter	dexter (R)
quartz	quart (R) z (S)
quiet	quiet (R)
quit	quit (R)
quaintance	quaint (R) ance (S)
urban	urban (R)
acquaintance	acquaint (R) ance (S)
intimate	intim (R) ate (S)
intimacy	intim (R) acy (S)
angel	angel (R)
motorball	motor (R) ball (S)
del	del (R)
delete	delete (R)
scenario	scene (R) ar (S) io (S)
scene	scene (R)
transdisciplinary	trans (P) discipline (R) ary (S)
timecube	time (R) cube (R)
turret	turret (R)
readapt	re (P) adapt (R)
readd	read (R) d (S)
misled	mis (P) led (R)
LED	led (R)
reinforcement	reinforce (R) ment (S)
reins	rein (R) s (S)
reimbursement	re (P) im (P) burse (R) ment (S)
bridegroom	bride (R) groom (R)
yelled	yell (R) ed (S)
virgin	virgin (R)
righteousness	right (R) eous (S) ness (S)
parable	fable (R)
paragraph	paragraph (R)
bible	bible (R)
biblical	bible (R) ic (S) al (S)
hebrew	hebrew (R)
christos	christ (R) os (P)
ulterior	ul (P) terior (R)
beset	beset (R)
hypebeast	hype (P) beast (R)
leung	leung (R)
infuriating	in (P) furi (R) ate (S) ing (S)
malfesance	mal (P) fe (R) se (S) ance (S)
vilain	vil (R) ain (S)
squirm	squirm (R)
collude	col (P) lude (R)
lude	lude (R)
chanted	chant (R) ed (S)
hermit	hermit (R)
reap	reap (R)
atrocious	atroc (R) ious (S)
slavery	slave (R) ery (S)
racism	race (R) ism (S)
lynch	lynch (R)
mete	mete (R)
retribution	retribute (R) ion (S)
decree	decree (R)
refute	refute (R)
allegory	allegor (R) y (S)
veil	veil (R)
stagnation	stagn (R) ation (S)
indiscriminately	in (P) discriminate (R) ly (S)
regimes	regime (R) es (S)
wind	wind (R)
wound	wound (R)
dove	dive (R) ed (S)
does	do (R) es (S)
did	did (R)
elicit	elicit (R)
cynicism	cynic (R) ism (S)
procrastinate	pro (R) cra (S) s (S) tine (S) ate (S)
coalition	coalit (R) ion (S)
radicalization	radical (R) ize (S) ation (S)
uygur	uygur (R)
rebuke	rebuke (R)
uighur	uighur (R)
governor	govern (R) or (S)
foe	foe (R)
foes	foe (R) es (S)
atrocities	atroc (R) ity (S) ies (S)
persecution	per (P) secu (R) tion (S)
celestial	celest (R) ial (S)
caricature	caricat (R) ure (S)
lachrymators	lachrym (R) ate (S) or (S) s (S)
bourne	bour (R) ne (S)
bournemouth	bour (R) ne (S) mouth (R)
jostling	jostle (R) ing (S)
canister	can (R) ister (S)
hypocritical	hypo (P) critic (R) al (S)
barricades	barry (R) ic (S) ade (S) es (S)
clown	clown (R)
vigilante	vigil (R) ante (P)
satire	satire (R)
emblem	emblem (R)
graphql	graph (R) q (R) l (R)
domestic	domest (R) ic (S)
housingauthority	house (R) ing (S) auth (R) or (S) ity (S)
engaging	engage (R) ing (S)
multigpus	multi (P) gpu (R) s (S)
definite	definite (R)
definitive	definite (R) ive (S)
surge	surge (R)
prominence	promin (R) ence (S)
valuing	val (R) ue (S) ing (S)
shattering	shatter (R) ing (S)
supernova	super (P) nova (R)
glimmers	glim (R) mer (S) s (S)
newsletter	news (R) letter (R)
autoregressive	auto (P) regress (R) ive (S)
strangling	strangle (R) ing (S)
delta	delta (R)
chatbot	chat (R) bot (R)
railway	rail (R) way (S)
spiderman	spider (R) man (S)
skyscrapper	sky (R) scrap (R) er (S)
automotive	auto (P) motive (R)
nonmonotonic	non (P) mono (P) tone (R) ic (S)
neural	neur (P) al (R)
tiananman	tian (R) an (S) man (S)
massacre	mass (R) acre (R)
consortium	consort (R) ium (S)
benchmark	bench (R) mark (R)
implemented	implement (R) ed (S)
narrator	narrat (R) or (S)
combination	combine (R) ation (S)
favourite	favour (R) ite (S)
favorite	favor (R) ite (S)
gamemode	game (R) mode (R)
graphQL	graph (R) q (R) l (R)
reactjs	react (R) j (R) s (S)
python	python (R)
javascript	java (R) script (R)
mystery	mystery (R)
estimation	estim (R) ation (S)
keras	ke (R) ras (R)
async	a (P) sync (R)
sync	sync (R)
accenture	accent (R) ure (S)
selenium	selen (R) ium (S)
advisory	advise (R) ory (S)
cloudian	cloud (R) ian (S)
chrome	chrome (R)
authenticate	auth (R) ent (S) ice (S) ate (S)
auth	auth (R)
authentication	auth (R) ent (S) ice (S) ation (S)
generalized	general (R) ize (S) ed (S)
supposedly	suppose (R) ed (S) ly (S)
timber	tim (R) ber (S)
log	log (R)
logging	log (R) ing (S)
russia	russia (R)
clein	cle (S) in (R)
klein	kle (S) in (R)
VMware	vm (R) ware (S)
daughter	daughter (R)
it	it (R)
IT	it (R)
LiyuanLucasLi	li (R) yuan (R) lucas (R) li (R)
shopee	shop (R) ee (S)
singapore	singapore (R)
cristinao	crist (R) ina (S) o (S)
Rolando	roland (R) o (S)
Ronaldo	ronald (R) o (S)
optimization	optim (R) ize (S) ation (S)
GA	ga (S)
reaffirming	re (P) affirm (R) ing (S)
conduce	conduce (R)
daughter	daughter (R)
citywide	city (R) wide (R)
marketable	market (R) able (S)
clashed	clash (R) ed (S)
clashes	clash (R) es (S)
bolster	bolster (R)
revolt	rev (R) o (S) lt (S)
cunt	cun (R) t (R)
deanonymization	de (P) anonym (R) ize (S) ation (S)
chanting	chant (R) ing (S)
aggressive	aggress (R) ive (S)
aggregate	aggreg (R) ate (S)
aggravate	aggrav (R) ate (S)
spare	spare (R)
stricken	strike (R) en (P)
stifle	stifle (R)
stiff	stiff (R)
ditch	ditch (R)
cite	cite (R)
citing	cite (R) ing (S)
binarize	bin (P) ariz (R) e (S)
numberize	number (R) ize (S)
departure	depart (R) ure (S)
skeptic	skept (R) ic (S)
synthesizing	syn (P) the (R) size (R) ing (S)
adversarial	adverse (R) ar (S) ial (S)
Behemoth	behemoth (R)
spire	spire (R)
spiral	spire (R) al (S)
rebuke	rebuke (R)
behaviour	behave (R) iour (S)
crippled	cripple (R) ed (S)
unprecedented	un (P) precede (R) ent (S) ed (S)
scrambling	scramble (R) ing (S)
aftermath	after (P) math (R)
pledged	pledge (R) ed (S)
travellers	travel (R) er (S) s (S)
thousands	thousand (R) s (S)
rectification	rect (P) i (R) fic (S) ation (S)
heuristic	heurist (R) ic (S)
preliminaries	pre (P) lim (R) in (P) aries (R)
distort	dist (R) ort (S)
hippocratic	hip (R) ocrat (S) ic (S)
obey	obey (R)
obedience	obedi (R) ence (S)
rebellion	rebell (R) ion (S)
lodge	lodge (R)
brink	brink (R)
consulate	consul (R) ate (S)
detain	de (R) tain (S)
bothersome	bother (R) some (S)
reservoir	reserve (R) o (S) ir (S)
autoimmune	auto (P) im (P) mu (R) ne (S)
diary	diary (R)
unacceptable	un (P) accept (R) able (S)
suffrage	suf (R) rage (S)
sullen	sull (R) en (S)
shutter	shutter (R)
Parmitano	par (P) mite (R) an (S) o (S)
subsystem	sub (P) system (R)
sys	sys (R)
dismantle	dis (P) mantle (R)
consulate	consul (R) ate (S)
halt	halt (R)
nefarious	ne (S) fare (R) ious (S)
peculiar	peculi (R) ar (S)
dissipate	dis (P) sip (R) ate (S)
outstationed	out (P) station (R) ed (S)
starcitizen	star (R) city (R) izen (S)
possibilities	possib (R) ile (S) ity (S) ies (S)
beneficiary	benef (R) ic (S) iary (S)
custodian	cust (R) o (P) dian (R)
inaugurated	inaugur (R) ate (S) ed (S)
loom	loom (R)
skim	skim (R)
mesmerizing	mesmer (R) ize (S) ing (S)
infrared	infra (P) red (R)
conundrum	conundrum (R)
nascent	nas (P) cent (R)
butler	butler (R)
butcher	butcher (R)
proteinuria	protein (R) uria (S)
polyarthritis	poly (P) arthr (P) itis (R)
Syndrome	syn (P) drome (R)
telangiectasia	tel (R) angi (P) ect (P) asia (R)
Centromeric	centr (R) om (P) eric (R)
phenomenon	phenomen (R) on (S)
sclerodactyly	sclero (P) dactyl (P) y (R)
bibasilar	bi (P) basil (R) ar (S)
ibrosis	i (P) bro (P) sis (R)
visceral	viscer (P) al (R)
involvement	involve (R) ment (S)
dysphagia	dys (P) phage (R) ia (S)
normocytic	normo (P) cy (P) t (R) ic (S)
haemolytic	haemo (R) lytic (S)
resorption	re (P) sore (R) ption (S)
v	v (R)
vasodilators	vaso (P) dilate (R) or (S) s (S)
polymyositis	poly (P) myo (P) site (R) is (S)
insidious	in (P) side (R) ious (S)
proximal	proxim (R) al (S)
stiffness	stiff (R) ness (S)
contractures	contract (R) ure (S) es (S)
malaise	malay (R) ise (S)
oedema	o (R) ed (S) eme (S) a (S)
thyroid	thyro (R) oid (S)
Guillian	gu (R) ille (S) ian (S)
Neurology	neur (P) olog (R) y (S)
denervation	de (P) nerve (R) ation (S)
myopathy	myo (P) pathy (R)
stipend	stip (R) end (S)
asbesto	rock (R) wool (R)
confiscated	confisc (R) ate (S) ed (S)
resentment	resent (R) ment (S)
quasiparticle	quasi (P) particle (R)
preclude	pre (P) clude (R)
prenatally	pre (P) natal (R) ly (S)
pegan	peg (R) an (S)
monotheistic	mono (P) theo (P) ist (S) ic (S)
rampant	ramp (R) ant (S)
unanimous	unanimous (R)
totipotent	toti (P) potent (R)
toti-	tote (R) i (S) -
lignify	ligni (R) fy (S)
hispanic	hispan (R) ic (S)
flock	flock (R)
hereditary	heredit (R) ary (S)
inherit	inherit (R)
nomadic	nomad (R) ic (S)
conscription	conscript (R) ion (S)
conundrum	conundrum (R)
noxious	noxi (R) ous (S)
compendium	compendium (R)
sapphire	sapphire (R)
waveguide	wave (R) guide (R)
neanderthal	neanderthal (R)
commemorate	com (P) memor (R) ate (S)
enantiomer	enantio (P) mer (R)
iridectomy	irid (P) ectomy (R)
opposite	oppose (R) ite (S)
iridescent	iridescent (R)
acknowledge	ac (P) know (R) ledge (S)
conference	confer (R) ence (S)
multicatalytic	multi (P) cataly (R) te (S) ic (S)
racemic	racem (R) ic (S)
enanitomer	enanito (P) mer (R)
shudder	shudder (R)
olfactory	olfact (R) ory (S)
galaxy	galaxy (R)
galaxies	galaxy (R) ies (S)
accustomed	ac (P) cust (R) om (S) ed (S)
stewardship	steward (R) ship (S)
innerdisciplinary	inner (R) discipline (R) ary (S)
interdisciplinary	inter (P) discipline (R) ary (S)
breast	breast (R)
birthplace	birth (R) place (R)
misidentify	mis (P) ident (R) ify (S)
retirement	retire (R) ment (S)
avocado	avocado (R)
brown	brown (R)
xmltree	xml (R) tree (R)
fossil	foss (R) il (S)
debunked	de (P) bunk (R) ed (S)
dwarf	dwarf (R)
noodle	noodle (R)
turmoil	turm (R) oil (R)
slam	slam (R)
decline	decline (R)
ghoul	ghoul (R)
groom	groom (R)
delicacies	delic (R) acy (S) ies (S)
tasting	taste (R) ing (S)
crew	crew (R)
chronicle	chron (R) icle (S)
hormone	hormone (R)
caribbean	ca (R) rib (R) ean (S)
caveat	caveat (R)
postulate	postul (R) ate (S)
panpsychism	pan (P) psyche (R) ism (S)
consciousness	consci (R) ous (S) ness (S)
Templeton	templet (R) on (S)
amouranth	amour (R) ane (S) th (S)
autumn	autumn (R)
clamshell	clam (R) shell (R)
bamboozle	bam (R) boo (R) zle (S)
goofy	goof (R) y (S)
inerranous	in (P) erran (R) ous (S)
inerrany	in (P) erran (P) y (R)
yardsticks	yard (R) stick (R) s (S)
dinosaur	dinosaur (R)
era	era (R)
shield	shield (R)
spacewalk	space (R) walk (R)
stimulus	stimul (R) us (S)
stimuli	stimul (R) us (S) s (P)
downplay	down (R) play (R)
recession	recede (R) sion (S)
bolster	bolster (R)
loaves	loaf (R) s (P)
loaf	loaf (R)
pipeline	pipe (P) line (R)
violin	viol (R) in (S)
tout	tout (R)
rigorous	rigor (R) ous (S)
nonindependent	non (P) in (P) depend (R) ent (S)
starcrafts	star (R) craft (S) s (S)
boomerang	boom (R) er (S) ang (S)
thor	thor (R)
metaflow	meta (P) flow (R)
laptop	lap (R) top (R)
armor	armor (R)
darius	da (R) rius (S)
breaker	break (R) er (S)
armour	armour (R)
innosport	inno (P) sport (R)
innospot	inno (P) spot (R)
flock	flock (R)
maven	maven (R)
overwintering	over (R) winter (R) ing (S)
exemplify	exemple (R) ify (S)
fulcrum	fulcrum (R)
imagery	image (R) ery (S)
strat	strat (R)
strategy	strateg (R) y (S)
winrate	win (S) rate (R)
unite	unit (R) e (S)
unit	unit (R)
unittest	unit (R) test (S)
latte	latte (R)
greentea	green (R) tea (R)
jesus	jesus (R)
fwd	f (R) w (R) d (S)
render	render (R)
finger	finger (R)
lung	lung (R)
lungs	lung (R) s (S)
polymer	poly (P) mer (R)
funny	fun (R) y (S)
craze	craze (R)
crazy	crazy (R)
crime	crime (R)
cream	cream (R)
dream	dream (R)
dreamt	dream (R) ed (S)
learnt	learn (R) ed (S)
forty	four (R) ty (S)
thirteen	third (R) teen (S)
thirty	third (R) ty (S)
thirsty	thirst (R) y (S)
seventh	seven (R) th (S)
eleven	eleven (R)
twelve	twelve (R)
twelth	twelve (R) th (P)
twelfth	twelve (R) th (P)
synopsis	synops (R) is (S)
sparknotes	spark (R) note (R) es (S)
stark	stark (R)
forteen	four (R) teen (S)
fortress	fort (R) ress (S)
eighth	eight (R) th (P)
ninth	nine (R) th (S)
ultra	ultra (R)
extra	extra (R)
rubberband	rubber (R) band (R)
rarest	rare (R) est (S)
cheer	cheer (R)
battlecruisers	battle (R) cruise (R) er (S) s (S)
kanji	kan (R) ji (R)
gender	gender (R)
grader	grade (R) er (S)
liuzhou	liu (R) zhou (R)
luosifen	luo (R) si (R) fen (R)
liziqi	li (R) zi (R) qi (R)
slurpy	slurp (R) y (S)
ultron	ult (P) ron (R)
oops	oops (R)
teespring	tee (R) spring (R)
fnproduction	f (R) n (S) produce (R) tion (S)
interstellar	inter (P) ste (P) ll (R) ar (S)
quantifiable	quant (R) ify (S) iable (S)
connection	connect (R) ion (S)
mutation	mutate (R) ion (S)
swallow	swallow (R)
switch	switch (R)
stitch	stitch (R)
protosaber	proto (P) saber (R)
sober	sober (R)
bamboo	bam (R) boo (R)
sophisticated	soph (R) ist (S) ice (S) ate (S) ed (S)
mercenary	mer (P) cen (R) ary (S)
rescue	rescue (R)
orlan	or (R) lan (R)
velerian	vel (R) e (S) rian (S)
relinquish	relinquish (R)
devilish	devil (R) ish (S)
proparoxytone	pro (P) par (P) oxy (P) tone (R)
leekin	lee (R) kin (S)
twitter	twitter (R)
coalesce	coalesce (R)
vertical	vert (R) ic (S) al (S)
horizontal	horizon (R) tal (S)
federated	fed (R) era (R) ted (R)
bittersweet	bitter (R) sweet (R)
causuality	cause (R) ual (S) ity (S)
buzz	buzz (R)
ethical	ethic (R) al (S)
actionable	ace (R) tion (S) able (S)
panel	pane (R) el (S)
rebuttal	re (P) but (P) al (R)
mockery	mock (R) ery (S)
peerreview	peer (R) review (R)
cryptic	crypt (R) ic (S)
inefficient	in (P) effic (R) ient (S)
traditional	tradite (R) ion (S) al (S)
exponential	exponent (R) ial (S)
thoroughness	thorough (R) ness (S)
surrealist	sur (P) real (R) ist (S)
wildest	wild (R) est (S)
factor	factor (R)
rant	rant (R)
convoluted	con (P) volute (R) ed (S)
paperswithcode	paper (R) s (P) with (R) code (R)
advent	advent (R)
paradigm	paradigm (R)
refine	re (P) fine (R)
redundancy	redund (R) ancy (S)
manuscript	manu (P) script (R)
summarize	summary (R) ize (S)
postgrad	post (P) grad (R)
graduate	gradu (R) ate (S)
postgraduate	post (P) gradu (R) ate (S)
comprehend	comprehend (R)
comprehension	comprehens (R) ion (S)
israeli	israel (R) i (S)
galaxies	galaxy (R) ies (S)
snatch	snatch (R)
aladdin	ala (R) d (S) in (S)
ozzy	oz (R) zy (S)
celebrate	celebr (R) ate (S)
thunder	thunder (R)
shield	shield (R)
ill	ill (R)
illusion	illus (R) ion (S)
docking	dock (R) ing (S)
oddity	odd (R) ity (S)
mindstorms	mind (R) storm (R) s (S)
finland	fin (R) land (R)
finala	final (R) a (S)
riemann	ri (S) em (P) ann (R)
mann	man (R) n (S)
resonance	re (P) sone (R) ance (S)
flashbangs	flash (R) bang (R) s (S)
compilation	comp (R) ile (S) ation (S)
harvard	harvard (R)
liquid	liquid (R)
grief	grief (R)
crowdpleasing	crowd (R) please (R) ing (S)
heist	heist (R)
dissemble	dis (P) semble (R)
disassemble	dis (P) assemble (R)
traumatic	traumat (R) ic (S)
punk	pun (R) k (S)
conclude	conclude (R)
exclusion	ex (P) cl (P) u (R) sion (S)
preclusion	pre (P) cl (P) u (R) sion (S)
constrained	con (P) strain (R) ed (S)
yunnan	yun (R) an (S)
unironically	uni (P) ro (P) nic (R) ally (R)
formidable	form (R) ide (S) able (S)
deaf	deaf (R)
Exclusivity	ex (P) cl (P) u (R) sive (S) ity (S)
graphcore	graph (R) core (R)
consolidation	con (P) solid (R) ation (S)
throughout	through (R) out (R)
feitsui	fei (R) tsui (R)
chuan	chuan (R)
zeroone	zero (R) one (S)
unification	uni (R) fic (S) ation (S)
manner	manner (R)
mannerproduction	manner (R) produce (R) tion (S)
polish	polish (R)
replenish	rep (R) len (R) ish (S)
dock	dock (R)
intuitive	intuit (R) ive (S)
command	command (R)
sandwish	sand (R) wish (R)
readd	read (R) d (S)
readdept	read (R) dept (R)
readapt	re (P) adapt (R)
rearrange	re (P) arrange (R)
rear	rear (R)
cooperate	co (P) operate (R)
cooper	co (P) oper (R)
copper	copper (R)
Diiterate	di (P) ter (P) eat (R) ed (S)
diindolylmethane	di (P) indo (P) l (R) yl (S) meth (R) ane (S)
diisopropylamine	di (P) iso (P) prop (R) yl (S) amine (R)
chlorophyll	chloro (P) phy (R) ll (R)
turkish	turk (R) ish (S)
turmoil	turm (R) oil (R)
turm	turm (R)
innovate	innovate (R)
innoval	inno (P) val (R)
best	good (R) est (S)
nanooperation	nano (P) operate (R) ion (S)
feed	feed (R)
foodie	food (R) ie (S)
biink	bi (P) in (P) k (R)
blink	blink (R)
biorr	bie (R) or (S) r (R)
biore	bio (P) re (R)
biopsy	bi (R) opsy (S)
bioodd	bio (P) odd (R)
loose	loose (R)
compliment	compl (R) iment (S)
complement	complement (R)
further	far (R) er (S)
farther	far (R) er (S)
hung	hung (R)
hanged	hang (R) ed (S)
outlook	out (P) look (R)
outgoing	out (P) go (R) ing (S)
outof	out (P) of (R)
handshaking	hand (R) shake (R) ing (S)
handbag	hand (R) bag (S)
christmastree	christ (R) mas (S) tree (R)
homonyms	homo (R) nym (S) s (S)
left	left (R)
right	right (R)
timelapse	time (R) lap (R) se (S)
empathy	em (P) pathy (R)
mysterio	myster (R) io (S)
loh	lo (R) h (S)
toh	to (P) h (R)
retrospect	retro (P) spect (R)
zigbee	zig (R) bee (R)
zigzag	zig (R) zag (R)
alliance	ally (R) iance (S)
bypass	bypass (R)
strain	strain (R)
strange	strange (R)
range	range (R)
arrange	arrange (R)
alpharstar	alphar (R) star (R)
increment	increm (R) ent (S)
transform	trans (P) form (R)
terraform	terra (P) form (R)
brilliance	brilli (R) ance (S)
annotate	an (P) notate (R)
clutch	clutch (R)
famous	fame (R) ous (S)
infinity	in (P) finite (R) y (S)
invisilime	in (P) vis (R) il (S) ime (S)
coliving	cole (R) ive (S) ing (S)
your	you (R) 's (S)
ur	ur (P)
funeral	funer (R) al (S)
reflexology	reflex (R) olog (S) y (S)
fraudulently	fraud (R) ule (S) ent (S) ly (S)
stresseating	stress (R) eat (R) ing (S)
manifestation	manifest (R) ation (S)
quack	quack (R)
shun	shun (R)
rollar	roll (R) ar (S)
coaster	coast (R) er (S)
airport	air (R) port (R)
qing	qing (R)
qinghai	qing (R) hai (R)
parttime	part (R) ime (S)
hairstylist	hair (R) style (S) ist (S)
eargasm	ear (R) gas (R) m (S)
raucous	rauc (R) ous (S)
atrophy	atroph (R) y (S)
biggest	big (R) est (S)
development	develop (R) ment (S)
spinal	spine (R) al (S)
novartis	nov (R) arti (P) s (R)
gene	gene (R)
therapy	therap (P) y (R)
bloom	bloom (R)
wuhan	wu (R) han (R)
linguist	lingu (R) ist (S)
single	single (R)
disseminate	dissemin (R) ate (S)
friendversary	friend (R) verse (R) ary (S)
deliverance	deliver (R) ance (S)
algodoo	algo (P) do (R) o (S)
etiquette	etiquette (R)
ditch	ditch (R)
heist	heist (R)
turtle	turtle (R)
flimsy	flim (R) sy (S)
bestowing	bestow (R) ing (S)
mandrill	man (R) drill (R)
nigerian	niger (R) ian (S)
mosic	mos (R) ic (S)
mosaic	mosaic (R)
toenail	toe (R) nail (S)
imperative	im (P) per (R) ative (S)
nascent	nas (P) cent (R)
malpractice	mal (P) pract (R) ice (S)
spirituality	spirit (R) ual (S) ity (S)
diamondis	diamond (R) is (S)
coexist	co (P) exist (R)
uplife	up (R) life (R)
uplift	up (R) lift (R)
dematerializer	de (P) materi (R) ali (S) z (S) er (S)
algodecathlon	algo (P) deca (P) th (P) lon (R)
thornmail	thorn (R) mail (R)
remastered	re (P) master (R) ed (S)
discipline	discipline (R)
restoration	restore (R) ation (S)
earthquakes	earth (R) quake (R) es (S)
state	state (R)
station	station (R)
static	static (R)
stateful	state (R) ful (S)
statist	statist (R)
pract	pract (R)
epistemologist	epistem (R) olog (S) ist (S)
woodpulp	wood (R) pulp (R)
pulp	pulp (R)
Leniency	len (R) ience (S) y (S)
Obedience	obedi (R) ence (S)
Decisiveness	dec (P) is (R) ive (S) ness (S)
Discernment	discern (R) ment (S)
Ingenuity	ingenu (R) ity (S)
Persuasiveness	persu (R) ase (S) ive (S) ness (S)
bolt	bolt (R)
logocentrism	logo (P) centre (R) ism (S)
petridish	petri (P) dish (R)
forfeit	forfeit (R)
faeces	faeces (R)
doughnuts	doughnut (R) s (S)
camouflage	camouflage (R)
meteorite	meteor (R) ite (S)
paperwhite	paper (R) white (R)
cement	cement (R)
quintuplet	quin (P) tuple (R) t (R)
chinchilla	chin (R) chill (R) a (S)
plank	plank (R)
huh	huh (R)
bestfriend	good (R) est (S) friend (R)
piston	piston (R)
fluid	fluid (R)
fight	fight (R)
fought	fight (R) ed (S)
quite	quite (R)
quiet	quiet (R)
mercury	mercury (R)
jettison	jet (R) ti (S) son (S)
whack	whack (R)
satellite	satellite (R)
coanda	co (R) and (S) a (S)
calamity	calam (R) ity (S)
rattata	rat (R) ta (S) ta (S)
tszyu	tsz (R) yu (R)
frankenstein	frank (R) en (P) stein (R)
microbes	micro (P) b (R) es (S)
taal	ta (R) al (S)
spike	spike (R)
acronym	acr (P) onym (R)
cyanide	cyan (R) ide (S)
swarm	swarm (R)
dimensionality	dimension (R) ali (S) ty (S)
oversampling	over (R) sample (R) ing (S)
interface	inter (P) face (R)
prosthetic	prosthe (R) te (S) ic (S)
mutation	mutate (R) ion (S)
alter	alter (R)
exploit	exploit (R)
mitigation	mite (R) i (S) ge (S) ation (S)
proverbial	pro (P) verb (R) ial (S)
vulnerability	vulner (R) abile (S) ity (S)
relies	rely (R) ies (S)
rely	rely (R)
lie	lie (R)
epitome	epi (P) tome (R)
studied	study (R) ied (S)
frontier	front (R) ier (S)
durian	dure (R) ian (S)
covenant	cove (R) en (S) ant (S)
mores	mores (R)
morality	moral (R) ity (S)
ethics	ethic (R) s (S)
ethos	etho (R) s (S)
fletcher	fletch (R) er (S)
lamentable	lament (R) able (S)
meddling	meddle (R) ing (S)
zergling	ze (P) r (R) gle (S) ing (S)
interoperability	inter (P) oper (R) abile (S) ity (S)
mustang	must (R) ang (S)
whip	whip (R)
piss	piss (R)
axle	axle (R)
curb	curb (R)
license	license (R)
threadmill	thread (R) mill (R)
pottery	pot (R) ery (S)
foveated	fove (R) ate (S) ed (S)
colexification	cole (R) xi (R) fic (S) ation (S)
reproducible	re (P) produce (R) ible (S)
polysemies	poly (P) sem (R) ies (S)
curate	cure (R) ate (S)
bracelet	brace (R) let (S)
hypersomnolence	hyper (P) somno (P) len (R) ce (S)
guidelines	guide (R) line (R) es (S)
sitagliptin	sit (R) ag (P) lip (P) tin (R)
Metformin	meet (R) ed (S) form (S) in (S)
rosiglitazone	ro (P) sig (R) lite (R) a (S) zone (R)
nightshifter	night (R) shift (R) er (S)
zen	zen (R)
Misconfigured	mis (P) con (P) figure (R) ed (S)
misconfiguring	mis (P) con (P) figure (R) ing (S)
rescan	re (P) scan (R)
vetted	vet (R) ed (S)
Xe	xe (R)
chromebook	chrome (R) book (R)
automatic	auto (P) mate (R) ic (S)
petyr	pet (R) yr (S)
baelish	ba (R) el (S) ish (S)
absurd	absurd (R)
pendulus	pend (R) ule (S) us (S)
kinematically	kinemat (R) ic (S) al (S) ly (S)
mercilessly	mercy (R) iless (S) ly (S)
paternoster	pat (R) ern (S) o (S) ster (S)
realistic	real (R) ist (S) ic (S)
demo	demo (R)
demon	demon (R)
tantamount	tantamount (R)
generalizability	general (R) ize (S) abile (S) ity (S)
binocular	bin (P) ocul (P) ar (R)
puberty	pub (R) er (S) ty (S)
Benjamin	ben (P) jam (R) in (S)
Minixhofer	mini (P) x (R) ho (R) fer (S)
Euthanization	eu (P) than (R) ize (S) ation (S)
preshared	pre (P) share (R) ed (S)
totalitarian	total (R) ite (S) arian (S)
devour	dev (R) our (S)
intonation	into (R) nation (R)
survivorship	survive (R) or (S) ship (S)
patchwork	patch (R) work (R)
earlybird	early (R) bird (R)
firefightet	fire (R) fight (R) et (S)
firefighter	fire (R) fight (R) er (S)
reggaeton	reg (R) ae (S) ton (S)
whimsical	whims (R) ic (S) al (S)
thermodynamics	thermo (P) dynam (R) ic (S) s (S)
sac	sac (R)
anal	anal (R)
irreplacable	ir (P) re (P) place (R) able (S)
irreplaceable	ir (P) re (P) place (R) able (S)
digitime	digit (R) ime (S)
supernova	super (P) nova (R)
lineages	line (R) age (S) es (S)
dethrone	de (P) throne (R)
recapitulation	re (P) capit (R) ule (S) ation (S)
measle	mea (R) sle (S)
mump	mump (R)
emergent	emerge (R) ent (S)
ragdolling	r (R) ag (P) dol (S) ling (R)
presumptive	pres (R) um (S) pt (S) ive (S)
scramble	scramble (R)
excavators	ex (P) ca (R) va (S) tor (S) s (S)
disparage	dis (P) pare (R) age (S)
tragedy	tragedy (R)
quarantine	quarant (R) ine (S)
bookstore	book (R) store (R)
petstore	pet (R) store (R)
distillation	distill (R) ation (S)
workout	work (R) out (R)
protein	protein (R)
overlooked	over (R) look (R) ed (S)
overcooked	over (R) cook (R) ed (S)
spectacular	spect (R) ac (S) ular (S)
operationalizing	operate (R) ion (S) ali (S) z (S) ing (S)
disinfectant	dis (P) infect (R) ant (S)
outbreak	out (P) break (R)
shrubbery	shrub (R) ery (S)
dictatorship	dict (R) ate (S) or (S) ship (S)
sanitation	sanit (R) ation (S)
nonexistant	non (P) exist (R) ant (S)
calamity	calam (R) ity (S)
flu	flu (R)
fly	fly (R)
flee	flee (R)
flew	fly (R) ed (S)
floppy	flop (R) y (S)
airborne	air (R) borne (R)
antidote	anti (P) dot (R) e (S)
subpoena	subpoen (R) a (S)
whistleblower	whistle (R) blow (R) er (S)
readies	ready (R) ies (S)
attorneys	attorney (R) s (S)
methodically	method (R) ic (S) al (S) ly (S)
interference	interfere (R) ence (S)
pneumonia	pneumon (R) ia (S)
coverup	cover (R) up (R)
commissar	commiss (R) ar (S)
chernobyl	cher (R) nob (R) yl (S)
unoccupied	un (P) occupy (R) ied (S)
pail	pail (R)
dissident	dis (P) ident (R)
virology	vir (R) olog (S) y (S)
viruse	vir (R) use (R)
antisepsis	anti (P) sep (R) sis (S)
extravagant	extravag (R) ant (S)
detrimental	detriment (R) al (S)
dwindle	dwindle (R)
megalovania	megalo (P) van (R) ia (S)
actuate	actu (R) ate (S)
actually	actual (R) ly (S)
autism	aut (P) ism (R)
turnaround	turn (R) around (R)
nab	na (R) b (R)
coagulated	coagul (R) ate (S) ed (S)
doomsday	dooms (R) day (S)
fluffing	fluff (R) ing (S)
postpone	postpone (R)
errorprone	error (R) prone (S)
chibanian	chi (R) bane (R) ian (S)
swirl	swirl (R)
memristor	memr (R) ist (S) or (S)
dunes	dun (R) es (S)
multivibrator	multi (P) vibr (R) ate (S) or (S)
greensleevs	green (R) sle (S) vs (R)
itenery	it (R) ene (S) ery (S)
itenary	it (R) ene (S) ary (S)
bipartisan	bi (P) party (R) isan (S)
blisters	blister (R) s (S)
indestructible	in (P) destruct (R) ible (S)
remorse	remorse (R)
extermination	ex (P) termin (R) ation (S)
gracious	grace (R) ious (S)
sacrilegious	sacr (R) ile (S) ge (S) ious (S)
reconnaissance	re (P) con (P) born (R) ance (S)
ridicule	ridicule (R)
maniacal	maniac (R) al (S)
clamouring	clamour (R) ing (S)
quotient	quote (R) ient (S)
plottwist	plot (R) twist (R)
foveated	fove (R) ate (S) ed (S)
hypervitaminosis	hyper (P) vit (R) amino (P) sis (R)
polyp	poly (P) p (R)
lesion	lesion (R)
illadvised	ill (P) advise (R) ed (S)
extremities	extreme (R) i (S) tie (S) es (S)
reflex	reflex (R)
monkeys	monk (R) ey (S) s (S)
tibia	tibia (R)
intact	intact (R)
thyroid	thyro (R) oid (S)
hypothyroidism	hypoth (R) yr (S) oid (S) ism (S)
elicit	elicit (R)
sucker	suck (R) er (S)
pulse	pulse (R)
spasms	spasm (R) s (S)
multitude	multi (P) tude (R)
illogical	il (P) logic (R) al (S)
hice	hic (R) e (S)
medulla	med (R) ul (S) la (S)
cerebellum	cerebell (P) um (R)
erythroped	erythro (P) pe (R) d (S)
prodigies	prodigy (R) ies (S)
bungalow	bungalow (R)
attic	attic (R)
syringomas	syringe (R) o (S) mas (S)
permafrost	perm (P) a (P) frost (R)
collapse	collapse (R)
disintegrating	dis (P) integr (R) ate (S) ing (S)
phenomenal	phenomen (R) al (S)
mint	min (R) t (R)
menthe	menth (R) e (S)
exert	exert (R)
hedgehog	hedge (R) hog (R)
dermatology	dermat (P) olog (R) y (S)
speical	speical (R)
registrar	reg (R) ister (S) er (S)
practitioner	pract (R) ition (S) er (S)
provision	prove (R) is (S) ion (S)
venereology	venereo (R) olog (S) y (S)
chamber	chamber (R)
robocall	robo (P) call (R)
pandamart	pand (R) am (P) art (R)
squawk	squawk (R)
hindi	hindi (R)
vodavone	vod (R) a (S) phone (S)
venerology	vener (R) olog (S) y (S)
fraught	fraught (R)
inflict	in (P) flict (R)
alphastar	alpha (P) star (R)
intellisense	int (R) ellis (R) en (S) se (S)
extravagant	extravag (R) ant (S)
mosaic	mosaic (R)
stemonitis	ste (P) monit (R) is (S)
lineart	line (R) art (R)
intellectual	intellect (R) ual (S)
inadvertently	in (P) ad (P) vert (R) ent (S) ly (S)
succinct	succinct (R)
bedtime	bed (R) time (R)
nerdy	nerd (R) y (S)
hentai	hen (R) tai (R)
unrealized	un (P) real (R) ize (S) ed (S)
gauge	gauge (R)
scrimp	scrimp (R)
station	station (R)
playstatiom	play (R) state (R) i (S) om (S)
playstation	play (R) station (R)
primodially	primo (P) dial (R) ly (S)
unidentified	un (P) ident (R) ify (S) ied (S)
preexisting	pre (P) exist (R) ing (S)
boon	boon (R)
Spamassassin	spam (R) assassin (R)
reminiscene	reminisce (R) ne (S)
unify	uni (R) fy (S)
whistle	whistle (R)
quarantine	quarant (R) ine (S)
ransomware	ransom (R) ware (S)
forfeit	forfeit (R)
abalone	abalone (R)
coercion	coerce (R) ion (S)
xanax	x (R) ana (S) x (S)
stentors	sten (P) tor (P) s (R)
sanvtuary	san (R) v (S) t (R) uary (S)
sanctuary	sanct (R) uary (S)
extubation	ex (P) tube (R) ation (S)
dethrone	de (P) throne (R)
atrocious	atroc (R) ious (S)
sibilants	sibil (R) ant (S) s (S)
spectre	spect (R) re (R)
synology	syn (P) olog (R) y (S)
terabytes	tera (P) byte (R) es (S)
mideast	mid (P) east (R)
concertmaster	concert (R) master (R)
thwart	thwart (R)
dehumidifier	de (P) humid (R) ify (S) ier (S)
traffick	traffick (R)
astronaut	astro (P) naut (R)
spondylolistheisis	spondylo (P) list (R) hei (R) sis (S)
desert	desert (R)
dessert	dessert (R)
desolate	desolate (R)
solitary	solit (R) ary (S)
alienation	alien (R) ation (S)
friendless	friend (R) less (S)
seclusion	seclude (R) sion (S)
lonesome	lone (R) some (S)
stradivirus	s (P) trade (R) ive (S) i (S) rus (S)
herniation	hern (R) ie (S) ation (S)
resorption	re (P) sore (R) ption (S)
lumbar	lumba (P) r (R)
disc	disc (R)
silos	sile (R) o (S) s (S)
treachery	treach (R) ery (S)
purveyor	p (R) ur (S) vey (S) or (S)
hatred	hatr (R) ed (S)
bassist	bass (R) ist (S)
sibilance	sibil (R) ance (S)
bennett	bennett (R)
hefty	hefty (R)
ashamed	a (P) shame (R) ed (S)
homeworker	home (R) work (R) er (S)
homeorder	home (R) order (R)
homeelderly	home (R) elder (R) ly (S)
infestation	infest (R) ation (S)
piezoelectricity	pie (R) zo (P) electr (P) ice (R) ity (S)
basetrade	base (R) trade (R)
plosive	plod (R) sive (S)
explosive	explode (R) sive (S)
buoyant	buoy (R) ant (S)
felony	felon (R) y (S)
riskaverse	risk (R) averse (R)
explanatory	ex (P) plan (R) ate (S) ory (S)
impeccable	im (P) pecc (R) able (S)
abscess	abscess (R)
venomous	venom (R) ous (S)
engulf	en (P) gulf (R)
prosthesis	prosthe (R) sis (S)
maneuvers	maneuver (R) s (S)
reminisce	reminisce (R)
notoriety	notori (R) et (S) y (S)
deuterium	deuter (R) ium (S)
revamp	re (P) vamp (R)
forth	forth (R)
unrequited	un (P) re (P) quite (R) ed (S)
parasite	para (P) site (R)
pleochroism	pleo (P) chro (R) ism (S)
snorkel	snorkel (R)
utensi	utensi (R)
utensil	utensil (R)
falsify	false (R) ify (S)
abyss	abyss (R)
bruh	bruh (R)
decry	dec (R) ry (S)
chlamydia	ch (S) lame (R) y (S) dia (R)
instigate	in (P) stig (R) ate (S)
tensegrity	ten (R) seg (R) ri (S) ty (S)
arived	a (P) rive (R) ed (S)
dispise	dis (P) pi (R) se (S)
soar	soar (R)
impression	impress (R) ion (S)
corticosteroid	cortico (P) ster (R) oid (S)
densly	den (R) sle (S) y (S)
pandemic	pand (R) eme (S) ic (S)
foothold	foot (R) hold (R)
variable	varie (R) able (S)
scary	scare (R) y (S)
plunge	plunge (R)
plummet	plum (R) et (S)
plumbis	plum (R) bis (P)
snatch	snatch (R)
philharmonie	phil (P) harmon (R) ie (S)
paradigm	paradigm (R)
reciprocity	re (P) ci (P) pro (P) city (R)
altruism	altru (R) ism (S)
solitary	solit (R) ary (S)
confinement	confine (R) ment (S)
cunning	cun (R) ing (S)
canning	can (R) ing (S)
harbor	harbor (R)
harbour	harbour (R)
autograding	auto (P) grade (R) ing (S)
commodity	com (P) mode (R) ity (S)
electrocardiogram	electro (P) cardio (P) gram (R)
exemplary	exemple (R) ary (S)
sporadic	sp (P) o (R) radic (P)
obliterate	ob (P) liter (R) ate (S)
fumble	fumble (R)
whistleblower	whistle (R) blow (R) er (S)
monstrosity	mon (P) st (P) rose (R) ity (S)
reauthenticating	re (P) auth (R) ent (S) ice (S) ate (S) ing (S)
microorganisms	micro (P) organ (R) ism (S) s (S)
blatantly	blat (R) ant (S) ly (S)
piggybacking	pig (R) y (S) back (S) ing (S)
reprimanding	re (P) prim (P) an (P) ding (R)
oopmh	oo (P) pm (R) h (S)
roopmh	ro (P) pm (R) h (S)
roomph	room (R) ph (S)
thoracentesis	thor (R) a (S) centesis (S)
dodecahedron	do (R) deca (P) hedr (R) on (S)
polyhedra	poly (P) hedr (R) a (S)
clementine	clement (R) ine (S)
mandarin	mandarin (R)
quel	que (R) el (S)
quelling	que (R) el (S) ling (S)
hoax	hoax (R)
fabricate	fabric (R) ate (S)
masquerade	masque (R) er (S) ade (S)
distinguishable	dist (R) in (S) guish (S) able (S)
slew	slay (R) ed (S)
inaugural	inaugur (R) al (S)
cremated	creme (R) ate (S) d (S)
latter	latter (R)
blase	blase (R)
debunked	de (P) bunk (R) ed (S)
staingate	stain (R) gate (R)
resurge	re (P) surge (R)
irresistable	ir (P) resist (R) able (S)
stadia	stad (R) ia (S)
tariff	tariff (R)
profusely	pro (P) fuse (R) ly (S)
shilling	shill (R) ing (S)
xemophobia	xe (R) mo (R) phobe (S) ia (S)
zenophobia	zen (R) o (S) phobe (S) ia (S)
lather	lath (R) er (S)
sterling	sterling (R)
loom	loom (R)
endocrinologist	endo (P) crin (R) olog (S) ist (S)
Acetobacterium	acet (R) o (P) bacteri (P) um (R)
termites	term (R) ite (S) es (S)
afaik	a (P) fai (R) k (S)
godawful	god (R) aw (R) ful (S)
bilabial	bi (P) labi (P) al (R)
phoneme	phone (R) me (S)
whim	whim (R)
simpl	simp (R) l (R)
marital	marit (R) al (S)
heterogeneous	hetero (P) gene (R) eous (S)
ultralearn	ultra (P) learn (R)
unkillable	un (P) kill (R) able (S)
memorandum	memor (R) and (S) um (S)
memoization	memo (R) ize (S) ation (S)
reprieve	rep (R) ri (S) eve (R)
ultra	ultra (R)
ultraportable	ultra (P) port (R) able (S)
reliance	rely (R) iance (S)
envoy	envoy (R)
laud	laud (R)
framing	frame (R) ing (S)
spillover	spill (R) over (S)
agylr	ag (P) yl (S) r (R)
agyle	age (R) y (S) le (S)
transpire	trans (R) pire (S)
incesstantly	in (P) cess (P) tan (R) tle (S) y (S)
digivolving	digi (P) volve (R) ing (S)
hyochlorite	hyo (P) chlor (R) ite (S)
inlets	in (P) let (R) s (S)
gurgling	gu (R) r (R) gle (S) ing (S)
diatomaceous	dia (P) tom (R) ace (S) eous (S)
xanthophytes	xantho (P) phyte (S) s (R)
chlorophyta	chloro (P) phyt (P) a (R)
electrophilicity	electro (P) phile (R) ice (S) ity (S)
aquatic	aquat (R) ic (S)
biome	bio (P) me (R)
cultivated	cultiv (R) ate (S) ed (S)
cyanobacteria	cyano (P) bacteri (P) um (R) s (P)
moot	mo (R) ot (S)
impregnated	im (P) pregn (R) ate (S) ed (S)
eyeglasses	eye (R) glass (R) es (S)
transuranium	trans (P) urani (R) um (S)
fascist	fasci (R) st (S)
pent	p (R) ent (S)
pants	pant (P) s (R)
hemolysis	hemo (R) lysis (S)
impunity	im (P) pun (R) ity (S)
ingrain	in (P) grain (R)
bailout	bail (R) out (R)
cringry	c (R) ring (R) ry (S)
cringey	cringe (R) y (S)
barred	barred (R)
adjudicate	ad (P) judic (R) ate (S)
clout	cl (P) out (R)
kowtow	kow (R) to (P) w (R)
policebrutality	police (R) brutal (R) ity (S)
commendable	comm (R) end (S) able (S)
ubiquitous	u (R) bi (P) quite (R) ous (S)
pretension	pre (R) tension (S)
pretend	pretend (R)
charade	char (R) ade (S)
dismayed	dis (P) may (R) ed (S)
paranoid	parano (R) oid (S)
silo	sile (R) o (S)
sabotaging	sabot (R) age (S) ing (S)
psychiatrist	psych (P) iatr (R) ist (S)
monetize	monet (R) ize (S)
fractionation	fract (P) ion (R) ation (S)
prestige	prestige (R)
mammoth	mammoth (R)
testifying	test (R) ify (S) ing (S)
imposter	imposter (R)
alluding	allude (R) ing (S)
narcissist	narciss (R) ist (S)
smugness	smug (R) ness (S)
exhillerate	ex (P) hill (R) er (S) ate (S)
acing	ace (R) ing (S)
civilianness	civil (R) ian (S) ness (S)
divulging	di (P) vul (R) ging (R)
resillient	re (P) sill (R) ient (S)
resilient	re (P) sile (R) ient (S)
nimble	nimble (R)
intubated	in (P) tube (R) ate (S) d (S)
chrysalis	chrys (P) ale (R) is (S)
infuriating	in (P) furi (R) ate (S) ing (S)
wizardry	wiz (R) ard (S) ry (S)
conjectured	con (P) ject (R) ure (S) ed (S)
waver	wave (R) er (S)
eschatological	eschat (R) olog (S) ic (S) al (S)
permabanned	perm (P) ab (P) anne (R) ed (S)
perm	perm (R)
daltonic	dal (P) tone (R) ic (S)
bungle	bungle (R)
underappreciated	under (P) appreci (R) ate (S) ed (S)
recession	recede (R) sion (S)
desolate	desolate (R)
delight	delight (R)
health	heal (R) th (S)
heath	heath (R)
inmate	in (P) mate (R)
fisherman	fish (R) er (S) man (S)
Hydroxychloroquine	hydr (R) oxy (P) chloro (P) que (R) ine (S)
explosive	explode (R) sive (S)
bikini	bikini (R)
hydroxychloroquine	hydr (R) oxy (P) chloro (P) que (R) ine (S)
confrontation	con (P) front (R) ation (S)
scintillator	sci (P) n (R) till (R) ate (S) or (S)
longstanding	long (R) stand (R) ing (S)
DescriptionPolytetrafluoroethylene	descript (R) ion (S) poly (P) tetra (P) fluoro (P) eth (P) yl (S) ene (S)
Polytetrafluoroethylene	poly (P) tetra (P) fluoro (P) eth (R) yl (S) ene (S)
fluoropolymer	fluoro (P) poly (P) mer (R)
flulike	flu (R) like (S)
desoldering	de (P) solder (R) ing (S)
offsets	offset (R) s (S)
cosponsor	co (P) sponsor (R)
treason	treason (R)
societal	societ (R) al (S)
social	soci (P) al (R)
unilaterally	uni (P) lateral (R) ly (S)
invade	invade (R)
mainsail	main (P) sail (R)
unwithered	un (P) with (R) er (S) ed (S)
reminiscent	reminisce (R) ent (S)
unknot	un (P) knot (R)
snarled	s (P) n (R) arl (S) ed (S)
longstanding	long (R) stand (R) ing (S)
tenure	ten (R) ure (S)
neomorphism	neo (P) morph (P) ism (R)
reignite	re (P) ignite (R)
axiomatic	axiom (R) ate (S) ic (S)
tensegrit	ten (R) seg (R) ri (S) t (R)
tensegrity	ten (R) seg (R) ri (S) ty (S)
procurement	procure (R) ment (S)
cozy	cozy (R)
sowing	sow (R) ing (S)
isochorix	iso (P) chore (R) i (S) x (S)
isochoric	iso (P) chore (R) ic (S)
isobaric	iso (P) bare (R) ic (S)
isothermic	iso (P) therm (R) ic (S)
adiabatic	ad (P) i (P) abate (R) ic (S)
cyclic	cycle (R) ic (S)
divisiveness	dive (R) is (S) ive (S) ness (S)
segmentation	seg (R) ment (S) ation (S)
panoptic	pan (R) optic (P)
confident	confide (R) ent (S)
confidant	confide (R) ant (S)
motifs	mo (R) tif (S) s (S)
Dysautonomia	dys (P) auto (P) nom (R) ia (S)
brook	brook (R)
enticing	ent (S) ice (R) ing (S)
allure	allure (R)
consoling	console (R) ing (S)
sworn	swear (R) en (P)
vehemently	ve (R) hey (R) ment (S) ly (S)
dastardly	dastard (R) ly (S)
grapples	grapple (R) es (S)
autopsy	autopsy (R)
asphyxia	asphyxi (R) a (S)
pessimistic	pessim (R) ist (S) ic (S)
pursuit	pursue (R) i (S) t (R)
pursue	pursue (R)
persue	persu (R) e (S)
reneged	rene (R) ge (S) ed (S)
reparable	re (P) fable (R)
pronounce	pro (P) nounce (R)
pronunciation	pronunciate (R) ion (S)
demilitarize	de (P) milit (R) ary (S) ize (S)
mayhem	may (R) hem (R)
delved	del (R) ve (S) ed (S)
dismantle	dis (P) mantle (R)
callously	callo (R) us (S) ly (S)
incite	in (P) cite (R)
demolition	demo (P) l (R) ition (S)
narcissist	narciss (R) ist (S)
sociopaths	socio (P) path (P) s (R)
hiace	hi (R) ace (S)
behavioral	behave (R) ior (S) al (S)
fish	fish (R)
fist	fist (R)
egregious	egreg (R) ious (S)
incantations	inc (R) ant (S) ation (S) s (S)
divine	divine (R)
confetti	con (P) fet (R) ti (S)
sciatic	sci (R) ate (S) ic (S)
dyslexia	dys (P) lex (R) ia (S)
travis	travis (R)
noblesse	noble (R) es (S) se (S)
bolstered	bolster (R) ed (S)
espionage	espi (R) one (S) age (S)
vaunted	vaunt (R) ed (S)
nanowire	nano (P) wire (R)
photoreceptors	photo (P) recept (R) or (S) s (S)
gladiator	glad (R) iate (S) or (S)
weaponry	weapon (R) ry (S)
rebuke	rebuke (R)
nationwide	nation (R) wide (R)
epoxy	ep (P) oxy (R)
busking	busk (R) ing (S)
bus king	bus (R) king (R)
fiend	f (R) i (S) end (S)
andromeda	andro (P) med (R) a (S)
milkiway	milk (R) i (S) way (S)
milkomeda	milk (R) ome (R) da (R)
meant	mean (R) ed (S)
hamstring	ham (R) string (R)
extensors	ex (P) tense (R) or (S) s (S)
fatigue	fatigue (R)
tight	tight (R)
sight	sight (R)
right	right (R)
pipe	pipe (R)
jail	jail (R)
jack	jack (R)
jacket	jacket (R)
lack	lack (R)
pack	pack (R)
scapula	s (P) cap (R) ula (S)
winged	wing (R) ed (S)
pelvic	pelvi (P) c (R)
pelvis	pelvi (P) s (R)
peloos	pel (R) o (S) s (S)
obliquity	ob (P) liqu (R) ity (S)
but	but (R)
anatomy	anatom (R) y (S)
thorough	thorough (R)
discrepancy	dis (P) crepe (R) ancy (S)
impingement	impinge (R) ment (S)
supine	sup (P) ine (R)
flaunt	flaunt (R)
sentropy	sent (R) rope (R) y (S)
endianness	end (R) ian (S) ness (S)
moratorium	more (R) a (S) to (S) rium (S)
leaner	lean (R) er (S)
tectonics	tect (R) onic (S) s (S)
secular	secular (R)
fractal	fract (P) al (R)
sapphire	sapphire (R)
exacerbate	ex (P) acerb (R) ate (S)
ravel	ra (S) vel (R)
eich	e (R) ich (S)
name	name (R)
slavery	slave (R) ery (S)
poise	poise (R)
theodorus	theodore (R) us (S)
cringest	cringe (R) est (S)
bitter	bitter (R)
endergonic	end (R) er (S) gon (S) ic (S)
exergonic	ex (P) er (R) gon (S) ic (S)
cudling	cud (R) ling (S)
resurgence	re (P) surge (R) ence (S)
transcenedental	trans (P) cen (R) ed (S) ent (S) al (S)
derangement	derange (R) ment (S)
tribalism	tribe (R) al (S) ism (S)
meritocracy	merit (R) ocracy (S)
skewed	skew (R) ed (S)
heavily	heavy (R) ily (S)
ruthless	ruth (R) less (S)
spiky	spike (R) y (S)
diorama	dioram (R) a (S)
dialects	dialect (R) s (S)
reengineer	re (P) engine (R) er (S)
lingojam	ling (R) o (P) jam (R)
freshen	fresh (R) en (S)
supercomputer	super (P) computer (R)
modchip	mod (R) chip (R)
adversity	adverse (R) ity (S)
copaganda	co (P) pagan (R) da (R)
multirotor	multi (P) rot (R) or (S)
notate	notate (R)
recalibration	re (P) calibre (R) ation (S)
telehealth	tele (P) heal (R) th (S)
Preamble	pre (P) amble (R)
teleconfidence	tele (P) confide (R) ence (S)
perplexity	perplex (R) ity (S)
reelect	re (P) elect (R)
decontamination	de (P) cont (R) amine (R) ation (S)
spintronics	sp (P) intro (P) nic (R) s (S)
carb	carb (R)
carbide	carb (R) ide (S)
silicon	silicon (R)
blindness	blind (R) ness (S)
transubstantiation	tran (R) substant (R) iate (S) ion (S)
circumcision	circum (P) cis (P) ion (R)
survey	survey (R)
convenor	convene (R) or (S)
blockaded	block (R) ade (S) ed (S)
reparation	rep (R) ar (S) ation (S)
sprung	spring (R) ed (S)
reciprocity	re (P) ci (P) pro (P) city (R)
stopper	stop (R) er (S)
korken	kor (R) ken (R)
vibe	vibe (R)
stor	s (P) tor (R)
sewing	sew (R) ing (S)
langsled	lang (R) sled (R)
rog	ro (P) g (R)
eriksson	erik (R) s (S) son (S)
thomas	thomas (R)
tout	tout (R)
esbuild	es (S) build (R)
stromal	st (P) rome (R) al (S)
concierge	con (P) ci (P) er (R) ge (S)
interstellar	inter (P) ste (P) ll (R) ar (S)
crowdsourcing	crowd (R) source (R) ing (S)
voiceover	voice (R) over (S)
repositories	re (P) posite (R) or (S) ies (S)
acretion	acre (R) tion (S)
exoplanet	exo (P) planet (R)
galaxies	galaxy (R) ies (S)
accretion	accrete (R) ion (S)
solarsystemers	solar (R) system (R) er (S) s (S)
reenabling	re (P) en (P) able (R) ing (S)
fascist	fasci (R) st (S)
empty	empty (R)
hallucination	halluc (P) ine (R) ation (S)
shapeshift	shape (R) shift (R)
interchangeable	inter (P) change (R) able (S)
ludicrously	ludicr (R) ous (S) ly (S)
checkerboard	check (R) er (S) board (R)
comcast	com (P) cast (R)
predecessor	pre (P) dec (P) esse (R) or (S)
cordon	cord (P) on (R)
sprout	sprout (R)
symbiotic	symb (R) iot (S) ic (S)
popstore	pop (R) store (R)
popupstore	pop (R) up (R) store (R)
clay	clay (R)
cosponsor	co (P) sponsor (R)
gatling	gat (R) ling (S)
racewalking	race (R) walk (R) ing (S)
nauseam	na (R) us (S) eam (S)
dangle	dang (R) le (S)
reveal	reveal (R)
refrain	refrain (R)
condemning	condemn (R) ing (S)
atrocities	atroc (R) ity (S) ies (S)
renaissance	re (P) born (R) ance (S)
lizard	lizard (R)
extinct	ex (P) tinct (R)
swine	swine (R)
sculpture	sculpt (R) ure (S)
translucent	trans (P) luc (R) ent (S)
phyllotactic	phyllo (P) tactic (R)
fractal	fract (P) al (R)
benign	benign (R)
malignant	malign (R) ant (S)
dermoscopy	dermo (P) scope (R) y (S)
secessionist	se (S) cede (R) sion (S) ist (S)
femise	fem (R) ise (S)
euology	eu (P) olog (R) y (S)
aspiration	aspirate (R) ion (S)
paranoia	parano (R) ia (S)
burrowed	burrow (R) ed (S)
doxed	dox (R) ed (S)
mundane	mund (R) ane (S)
milkilies	milk (R) ily (S) ies (S)
nonconformities	non (P) con (P) form (R) ity (S) ies (S)
kindred	kind (R) red (R)
blackmail	black (R) mail (R)
countertransference	counter (P) transfer (R) ence (S)
parentification	parent (R) ify (S) ic (S) ation (S)
guru	gu (R) ru (R)
psychodynamic	psycho (P) dynam (R) ic (S)
psychotherapy	psycho (P) therap (P) y (R)
eliciting	elicit (R) ing (S)
psychoanalytic	psycho (P) analy (R) te (S) ic (S)
fantasies	fan (R) tasy (S) ies (S)
pathological	patho (R) olog (S) ic (S) al (S)
Parataxic	para (P) tax (R) ic (S)
Conveyance	convey (R) ance (S)
heterosexual	hetero (P) sex (R) ual (S)
monogamous	mono (P) gamous (R)
denote	de (P) note (R)
therapeutic	therap (P) eu (P) t (R) ic (S)
turbocharged	turbo (P) charge (R) ed (S)
curtail	cur (P) tail (R)
dial	dial (R)
curfew	cur (P) few (R)
condolence	con (P) dole (R) ence (S)
comrades	comrade (R) es (S)
premise	premise (R)
prostrate	prostrate (R)
conspiracy	conspire (R) a (S) cy (S)
punitive	pun (R) itive (S)
Orwell	or (R) well (R)
resin	re (P) sin (R)
stethoscope	stetho (P) scope (R)
tendinous	tendin (R) ous (S)
muslim	muslim (R)
weasel	weasel (R)
quisling	qui (P) sling (R)
singleheaded	single (R) head (S) ed (S)
upheaval	up (R) heave (R) al (S)
dazzling	dazzle (R) ing (S)
jeopardize	jeopard (R) ize (S)
interdependencies	inter (P) depend (R) ency (S) ies (S)
Refraining	refrain (R) ing (S)
hypocrite	hypo (P) crit (R) e (S)
Contronyms	cont (R) ro (P) nym (S) s (R)
Antagonyms	ant (P) ag (P) onym (R) s (S)
jeopardy	jeopard (R) y (S)
draconian	dra (S) cone (R) ian (S)
intimidate	intim (R) ide (S) ate (S)
enslave	en (P) slave (R)
quirk	quirk (R)
weiners	wei (R) ner (S) s (S)
phenotypic	pheno (P) typic (R)
mendacious	mend (R) ace (S) ious (S)
digress	di (P) gress (R)
witchcraft	witch (R) craft (S)
racists	race (R) ist (S) s (S)
deportation	de (P) port (R) ation (S)
weir	weir (R)
electroluminous	electrol (R) um (S) ine (S) ous (S)
embroidered	emb (R) roe (S) ide (S) red (R)
raring	rare (R) ing (S)
cybernetic	cyber (P) net (R) ic (S)
neodyminum	neo (P) dy (P) min (R) um (S)
overhaul	over (R) haul (R)
drip	drip (R)
stylophone	style (R) o (S) phone (S)
ionosphere	ion (R) o (S) sphere (S)
blip	blip (R)
attenuation	attenu (R) ation (S)
extracut	extra (P) cut (R)
blunt	blunt (R)
orthopaedic	orthopaed (R) ic (S)
decontextualization	de (P) context (R) ual (S) ize (S) ation (S)
monger	monger (R)
retaliation	retaliate (R) ion (S)
astrology	astro (R) olog (S) y (S)
antiemetic	anti (P) em (R) et (S) ic (S)
analgesics	analges (R) ic (S) s (S)
galactagogue	galact (P) agog (R) ue (S)
epilepsy	ep (P) i (R) lepsy (S)
seizures	seize (R) ure (S) es (S)
fibromyalgia	fibro (P) my (R) algia (S)
generalized	general (R) ize (S) ed (S)
wavering	wave (R) ring (R)
piece	piece (R)
piecer	piece (R) er (S)
snowpiecer	snow (R) piece (R) er (S)
poised	poise (R) ed (S)
sulking	sulk (R) ing (S)
lash	lash (R)
rallied	rally (R) ied (S)
secession	se (S) cede (R) sion (S)
convenor	convene (R) or (S)
disbanded	dis (P) band (R) ed (S)
retroactive	retro (P) active (R)
domino	domin (R) o (S)
oppress	oppress (R)
councillor	council (R) or (S)
former	former (R)
shove	shave (R) ed (S)
swaddle	s (P) wad (R) dle (S)
explicative	ex (P) plicate (R) ive (S)
survive	survive (R)
acetylcholinesterase	acet (R) yl (S) chole (R) ine (S) ster (S) ase (S)
angst	angst (R)
zeitgeist	ze (P) it (R) ge (S) ist (S)
counterfactual	counter (P) fact (R) ual (S)
hypothesize	hypothe (R) size (R)
stump	stump (R)
ballyhooed	ball (R) y (S) hoo (S) ed (S)
cycloptic	cycl (P) opt (R) ic (S)
baldly	bald (R) ly (S)
femicide	fem (R) icide (S)
lexical	lex (R) ic (S) al (S)
defund	de (P) fund (R)
compliance	compl (R) iance (S)
untrue	un (P) true (R)
resolute	resolute (R)
thrifty	thrift (R) y (S)
modest	modest (R)
proactive	pro (P) active (R)
knowledgeable	know (R) ledge (S) able (S)
energetic	energ (R) et (S) ic (S)
endeavour	endeavour (R)
endeavor	endeavor (R)
liaise	liaise (R)
negotiate	negoti (R) ate (S)
snobbish	s (P) nob (R) ish (S)
prosperous	prosper (R) ous (S)
convertible	convert (R) ible (S)
scenic	scene (R) ic (S)
exotic	exot (R) ic (S)
clerical	cler (R) ic (S) al (S)
debatable	debate (R) able (S)
drastic	drastic (R)
atheleic	athe (P) lee (R) ic (S)
fabulous	fabul (R) ous (S)
demeaning	de (P) mean (R) ing (S)
solemn	solemn (R)
benevolent	bene (P) vol (R) ent (S)
apathetic	ap (P) a (P) thetic (R)
hilarious	hil (R) ary (S) ious (S)
consolidate	con (P) solid (R) ate (S)
refuse	refuse (R)
aural	aure (R) al (S)
dismantling	dis (P) mantle (R) ing (S)
itch	itch (R)
exoplanet	exo (P) planet (R)
wobbly	wobble (R) y (S)
herniate	hern (R) iate (S)
hormone	hormone (R)
predate	pre (P) date (R)
rim	rim (R)
speedier	speed (R) ier (S)
reagent	re (P) agent (R)
dealt	deal (R) ed (S)
bombarded	bomb (R) ard (S) ed (S)
nuisance	nue (R) is (S) ance (S)
misguided	mis (P) guide (R) ed (S)
faltered	falt (R) er (S) ed (S)
samsung	sam (R) sung (R)
galaxy	galaxy (R)
besieged	besiege (R) ed (S)
flanking	flank (R) ing (S)
motifs	mo (R) tif (S) s (S)
nucleotide	nucleo (P) tide (R)
elusive	el (P) u (R) sive (S)
adenine	aden (P) ine (R)
polymorphisms	poly (P) morph (P) ism (R) s (S)
pinpointing	pin (R) point (R) ing (S)
methylation	meth (R) yl (S) ation (S)
erode	erode (R)
mundane	mund (R) ane (S)
salvage	salve (R) age (S)
purge	purge (R)
utterly	utter (R) ly (S)
raid	raid (R)
delegation	deleg (R) ation (S)
postponement	postpone (R) ment (S)
enshrined	en (P) sh (P) rine (R) ed (S)
uphold	up (R) hold (R)
impunity	im (P) pun (R) ity (S)
poised	poise (R) ed (S)
treasury	treasure (R) y (S)
treason	treason (R)
neuropsychiatric	neuro (P) psych (P) iatr (R) ic (S)
jiffy	jif (R) fy (S)
femotometer	fem (R) oto (P) meter (R)
nucleus	nucle (P) us (R)
archaeology	archae (P) olog (R) y (S)
padilicious	pad (R) ile (S) ice (S) ious (S)
hijack	hi (R) jack (R)
unsavory	un (P) savor (R) y (S)
metamaterials	meta (P) materi (R) al (S) s (S)
centric	centre (R) ic (S)
conclusions	conclude (R) sion (S) s (S)
overparametrization	over (R) para (P) metr (R) ize (S) ation (S)
breakthrough	break (R) through (S)
compositionality	composite (R) ion (S) ali (S) ty (S)
constituents	constitu (R) ent (S) s (S)
substitutivity	substitu (R) tive (S) ity (S)
proclivity	pro (P) clive (R) i (S) ty (S)
wicked	wick (R) ed (S)
confer	confer (R)
pyrotechnics	pyro (P) techn (R) ic (S) s (S)
technographics	techn (R) o (S) graph (S) ic (S) s (S)
craniosynostosis	cranio (P) sy (R) nost (R) osis (S)
sagittal	s (P) agit (R) tal (S)
prospect	prospect (R)
prosperous	prosper (R) ous (S)
osteoarthritis	osteo (P) arthr (P) itis (R)
vaginosis	vagin (R) osis (S)
intractable	in (P) tract (R) able (S)
transplantation	trans (P) plant (R) ation (S)
crescent	cre (P) scent (R)
bail	bail (R)
heroine	hero (R) ine (S)
magistrate	mag (R) ist (S) rate (R)
magister	mag (R) ister (S)
confiscated	confisc (R) ate (S) ed (S)
seize	seize (R)
Valsalva	val (R) sal (S) va (S)
maneuver	maneuver (R)
exhalation	ex (P) hale (R) ation (S)
Hemodynamics	hemo (P) dynam (R) ic (S) s (S)
glottis	glott (R) is (S)
intervertebral	inter (P) vertebr (R) al (S)
intrathecal	intra (P) thec (P) al (R)
prolapse	pro (P) lap (R) se (S)
inflamed	in (P) flame (R) ed (S)
contraindications	contra (P) indic (R) ation (S) s (S)
Manoeuvre	manoeuvre (R)
intraabdominal	intra (P) abdomin (P) al (R)
intrathoracic	intra (P) thoraci (P) c (R)
ventricular	ventricul (P) ar (R)
obstruction	ob (P) struct (R) ion (S)
transiently	trans (R) ient (S) ly (S)
vagus	vag (R) us (S)
straining	strain (R) ing (S)
compensate	compens (R) ate (S)
thorax	thorax (R)
tachycardia	tachy (P) cardi (P) a (R)
supraventricular	supra (P) ventricul (P) ar (R)
tachyarrhythmia	tachy (P) ar (P) rhythm (R) ia (S)
arrhythmia	ar (P) rhythm (R) ia (S)
Atrial	a (P) trial (R)
strenuous	strenu (R) ous (S)
paroxysmal	par (P) oxy (P) s (R) mal (P)
convulsion	con (P) vul (R) sion (S)
exacerbation	ex (P) acerb (R) ation (S)
deterioration	deterior (R) ation (S)
labefaction	lab (R) ef (S) ac (S) tion (S)
alveolar	alveol (R) ar (S)
purulent	purul (R) ent (S)
influenza	influ (R) en (S) za (S)
pneumococcal	pneumo (P) co (P) cc (R) al (S)
prescribe	prescribe (R)
abnormalities	ab (P) normal (R) ity (S) ies (S)
embolism	em (P) bole (R) ism (S)
thromboembolism	thrombo (P) emb (R) ole (S) ism (S)
infarction	in (P) far (R) ce (S) tion (S)
shoulder	shoulder (R)
elbow	el (P) bow (R)
wrist	wrist (R)
knee	knee (R)
ankle	ankle (R)
aquamation	aqua (P) m (R) ation (S)
skies	sky (R) ies (S)
apostrophe	apostroph (R) e (S)
funerary	funer (R) ary (S)
numbing	num (R) bing (R)
mesmerizing	mesmer (R) ize (S) ing (S)
flyby	fly (R) by (R)
shaky	shake (R) y (S)
sealant	seal (R) ant (S)
veil	veil (R)
photovoltaics	photo (P) vol (P) ta (R) ic (S) s (S)
likewise	like (R) wise (S)
sustenance	sust (R) ene (S) ance (S)
scrumptious	scrum (R) pt (S) ious (S)
carve	carve (R)
carving	carve (R) ing (S)
roost	roost (R)
solvant	solve (R) ant (S)
solvent	solve (R) ent (S)
solvability	solve (R) abile (S) ity (S)
cosmonauts	cosmo (P) naut (R) s (S)
astronaut	astro (P) naut (R)
dazzling	dazzle (R) ing (S)
bloviator	bloviate (R) or (S)
attosecond	atto (P) second (R)
latching	latch (R) ing (S)
precursor	pre (P) curse (R) or (S)
helicarrior	heli (P) carrie (R) or (S)
slip	slip (R)
sip	sip (R)
quake	quake (R)
unearth	un (P) earth (R)
zooblast	zoo (P) blast (R)
zoochemistry	zoo (P) chemi (P) s (P) try (R)
zoodynamics	zoo (P) dynam (R) ic (S) s (S)
vicin	vicin (R)
vicinage	vicin (R) age (S)
minable	mine (R) able (S)
ferrallitic	fer (P) al (P) lite (R) ic (S)
mediastinum	mediast (R) in (S) um (S)
diaphragm	diaphragm (R)
magnanimously	magnanim (R) ous (S) ly (S)
magnaflux	magna (P) flux (R)
magnesia	magnes (R) ia (S)
magnocellular	magno (P) cell (R) ular (S)
parvocellular	parvo (P) cell (R) ular (S)
antagonistic	ant (P) agon (R) ist (S) ic (S)
astrophysics	astro (P) physic (R) s (S)
monuments	monument (R) s (S)
comm	comm (R)
commun	commun (R)
enduser	end (R) user (R)
haha	ha ha hah ha
hehehe	hhe heheh hehhh
